*   **               **         *
*     ***     D        ***      *
*     ***                       *
*                      *****    *
*           ****      ********  *
*           ***          ********
* **                      *******
******             ****     *** *
******              **          *
****                            *
*              **         *******
***            ***       ********
****                      ***** *
*                               *
*                s              *