*     **********************    *
*   *******   D    **********   *
*   *******                     *
* ****************    ***********
************          ********  *
*            ********************
* ********    *******************
*********                   *****
******       ************       *
****               *********    *
**      ******      *************
******************       ********
****      ****            ***** *
*                               *
*                s        ****  *