*************************************************
*  ********        *****   *   ****             *
* s******           *********  ****             *
* ******             ********   **             **
* *****       **      *******                  **
* *****      ***       ******      **          **
*   **        **       *******    ***          **
*                      *************            *
**                    *************             *
***                  ******  ******      *      *
****      **         *****    *****     ***     *
************          ***     ****      ***     *
************                            ***     *
***********                 **         ****     *
* *****                ***         *******     **
*                     *****        *******     **
*         **         ******         *****     ***
*        ***     **********          ****    ****
*         *     ************          ***    ****
*                ***********      *    **     ***
*                   *******             *       *
*          ***      ********                    *
*         *****     *************               *
*        ******    ***************             **
*  ***   ******     ***   *********            **
* *****   *****            ********        **  **
* *****     ****           ****  ***      *******
*  ***       ****         ****    **     ********
*             ****        *****   **     ********
*              ***       ******          ****  **
*  **          ****     *******          ***    *
* ****    *    ****************          **     *
* ****   ***   ***************           **     *
******   ***   *******  *****           ***     *
******    *    ****      ***         *******    *
*******                             *********  **
*******           ***                ************
*******          *****                    *******
*******         ******          ***        ******
***********    *****         *******        *****
********************  *     ********        *****
*      *****************    *******        ******
*           ************    ******         **** *
*            **********     *****           **  *
* *          *********     ****                 *
****        *********      ***                  *
****     ********           *                   *
***      ******                   *            **
***      *****                   ***         D***
****                    *****    ***    *********